å gå	to go
å arbeide	to work ("a..")
begge	both
fordi	because
fortalte (å fortelle)	told
gått (å gå)	gone (past part.)
hvor lenge	how long
å høre	to hear
hørte (å høre)	heard
å håpe	to hope
i fjor	last year
ikke sant?	right?
kom (å komme)	came
kommet (å komme)	come (past part.)
et kurs	a course
å lære	to learn
en lærer	a teacher
et lån	a loan
en nasjonalitet	a nationality
et navn	a name
et norskkurs	a Norwegian course
en pause	a break
et språk	a language
søt	sweet
tidlig	early
å trives	to thrive, enjoy oneself
en tysker	a German
å undervise	to teach
et viskelær	an eraser
visste (å vite)	knew
blå	blue
en butikk	a shop
dessuten	moreover, besides
fornøyd	satisfied, pleased
ganske	quite
en genser	a sweater
grønn	green
grå	grey
i dag	today
ei jakke	a jacket
kald	cold
en klesbutikk	a clothing store
klær	clothes (pl.)
ei kåpe	a coat
å like	to like
lysegrå	light grey
ny	new
å passe	to fit
praktisk	practical
å prøve	to try
et prøverom	a fitting room
et salg	a sale
et skjerf	a scarf
en størrelse	a size
svart	black
til sammen	together, in all
tykk	thick
varm	warm, hot
allerede	already
en bagett	a baguette
et bakeri	a bakery
å banke	to knock
å begynne	to begin
å bestemme	to decide
ei bok	a book
en bokhandel	a bookstore
ei dyne	a quilt
faktisk	actually
fire	four
for dyr	too expensive
for å	in order to ...
å ha lyst til å ...	want to, would like to
en handlekurv	a shopping basket
et humør	a mood
interessant	interesting
en interiørbutikk	interior design shop
ei kake	a cake
et kakestykke	a piece of cake
kjempebra	awesome, giant good
å kose seg	to have a good time, snuggle up
koselig	cosy, nice
å lese	to read
lita	small (f.)
lite	small (n.)
liten	small (m.)
et lys	a candle
en lysestake	a candlestick
lyst til (å ha lyst til å ...)	wanting to do something
mange	many
mer	more
myk	soft
ei notatbok	a notebook
om	about
ei ordbok	a dictionary
en penn	a pen
en prosent	a percentage
ei pute	a pillow, cushion
på salg	on sale
en roman	a novel
et semester	a semester
små	small (pl.)
å svare	to answer
å sykle	to bicycle
en tekopp	a teacup
annen	other
en bekreftelse	a confirmation
et brev	a letter
derfor	therefore
dit	there, yonder
et EØS-land	an EEA country
å fortelle	to tell
en fotoautomat	a photo machine
et gebyr	a fee, charge
en helseforsikring	a health insurance
å invitere	to invite
ja visst	surely, certainly
en jernbanestasjon	a railway station
en kø	a queue, line
å legge ved	to attach
en oppholdstillatelse	a residence permit
å registrere	to register
et registreringsbevis	a certificate of registration
en restaurant	a restaurant
en bytur	a trip to town
en CD	a CD
drakk (å drikke)	drank
etter	after
fant (å finne)	found
å finne fram	to find one's way
gikk (å gå)	walked, went
en mann	a man
en mobil	a cell phone
en muffins	a muffin
snakket (å snakke)	spoke
spiste (å spise)	ate
traff (å treffe)	met (casual, past tense)
vanskelig	difficult
var (å være)	was, were
veldig	very
en venn	a friend
å vise	to show
en brosjyre	a folder, brochure
dro (å dra)	left (to leave)
et fiskemarked	a fish market
foran	in front of
forrige	previous
ei gate	a street
greide	managed (to manage)
å greie	to manage
ei gågate	a pedestrian area
hadde (å ha)	had
en historie	a history, story
hjalp (å hjelpe)	helped
møtte (å møte)	met (formal)
sto (å stå)	stood
tok (å ta)	took
et torg	a square, a marketplace
travel	busy
ei uke	a week
et ansikt	a face
en bestefar	a grandfather
å bestille	to order
en farge	a colour
fattig	poor
forskjellig	different, various
få	few
glad	happy, glad
å glemme	to forget
hel	whole
hemmelig	secret
å holde	to hold, keep
hverandre	each other
i går	yesterday
i nærheten av	near, close to
kjempegod	very good
kjær	dear (adj.)
en lås	a lock
å låse	to lock
en mamma	a mom (casual form, baby talk)
et menneske	a person, human being
en nabo	a neighbour
et område	an area
ei oppskrift	a recipe
en pappa	a daddy
å passe på	to take care of, look after
rar	strange, odd (r...)
satt (å sitte)	sat
en servitør	a waiter
å sitte	to sit
ei sjokoladekake	a chocolate cake
snill	kind
spurte (å spørre)	asked
et stykke	a piece
en sykkel	a bicycle
en tid	a time
et trehus	a wooden house
tror (å tro)	believe
trygg	safe, secure
uten	without
åpen	open
et besøk	a visit
ble (å bli)	became
brant (å brenne)	burnt (to burn)
å brenne	to burn
bygde (å bygge)	built (to build)
å bygge	to build
cirka (ca.)	approximately, around (amount)
å dø	to die
døde (å dø)	died
en gang	a time (once)
en grav	a grave
en guide	a guide
igjen	again
en katedral	a cathedral
ei kirke	a church
Kong	King (as title)
en konge	a king
mellom	between
mett	full
rundt	round, about
å se ut	to look, appear
en skulptur	a sculpture
så (å se)	saw
trøtt	tired
en vikingkonge	a viking king
viktig	important
alle	all
en avgift	a fee
bare hyggelig!	you're welcome!
et bygg	a building
bøker (ei bok)	books
en campus	a campus
å dusje	to take a shower
en e-post	an e-mail
fem	five
før	before
et ID-kort	an ID card
en inngang	an entrance
et institutt	a department
en konsulent	an executive officer, consultant, adviser
et kontor	an office
lys	bright, light, blond
nettopp	just
en psykologi	a psycology
psykologisk	psycological
en semesteravgift	a university fee
et semesterkort	semester card
skrevet (å skrive)	written (past part.)
studiet (et studium)	the programme, study
et studium	a course of study
takk skal du ha	thanks to you
en telefon	a telephone
ved	at, by, near, on, to
vært (å være)	been (past part.)
en arkitektstudent	an architecture student
et bibliotek	a library
en foreleser	a lecturer
fått (å få)	got (past part.)
gjort (å gjøre)	done (past part.)
en gutt	a boy
å huske	to remember
i morgen	tomorrow
et kompendium	a compendium
lang	long (adj.)
en lunsj	a lunch
å låne	to borrow
møtt (å møte)	met (past part.)
naiv	naive
et nett	a web
noe	something, some (neuter)
sliten	weary, tired
en studieplan	a curriculum
sukker	sugar
en ting	a thing
truffet (å treffe)	met, hit (past part., casual)
et universitet	a university
et arrangement	an arrangement
å arrangere	to arrange, organise
et bilde	a picture
en dagsbillett	a single-day ticket
å danse	to dance
eller	or
en festival	a festival
en fotball	a football
et helårskort	a year round ticket
et hus	a house, building
et idrettssenter	a sports centre
en konsert	a concert
en lørdag	a Saturday
nær	near
en organisasjon	an organisation
på vei	on the way
rund	round
rød	red
å selge	to sell
sett (å se)	seen (past part.)
en side	a side
å skinne	to shine
ei sol	a sun
spesiell	special
å synes	find / perceive
et tangokurs	a tango dance course
å trene	to exercise, train
en volleyball	a volleyball
amerikansk	American
av og til	sometimes, occasionally
en ballett	a ballet
et ballspill	a ball game
et begynnerkurs	a beginner course
best	best
bordtennis	table tennis (uncount. noun)
cricket	cricket (uncount. noun)
di	your, yours (f. suffix form)
å diskutere	to discuss
å drive med noe	to do something
fritid	a spare time, leisure (uncount. noun)
en fritidsaktivitet	a leisure activity
gjør	do/does (present)
gøy	fun
heller	rather
et hjem	a home
et hjemland	a native country
en hobby	a hobby, pastime
hver	every, each
hvis	if
iblant	sometimes
en kino	a cinema
kjempemorsom	hilarious, very funny
en klasse	a class
å klatre	to climb
ei klatregruppe	a climbing group
lita	little, small (f.)
mitt	my, mine (n.)
mot	towards, against, also: courage
ofte	often
å rydde	to tidy, discard, clean up
siden	since
å snu	to turn
en sofa	a sofa, couch
en sport	a sport
en tango	a tango
ei tavle	a blackboard
tennis	tennis (uncount. noun)
et treningskort	gym membership card
en TV	a TV
en TV-serie	a TV series
vanligvis	usually
å vaske	to wash, clean
ei venninne	a (female) friend
jeg	I (subj.)
du	you (singular, subj.)
den	it (m./f.)
det	it (n.)
dere	you (plural)
du	you (singular subject)
den	it (m./f. subject)
det	it (n. subject)
deg	you (singular object, or refleksiv)
ham (han)	him (obj.)
henne	her (obj.)
den	it (m./f. object)
det	it (n. object)
oss	us (obj., reflek.)
Du går inn.	You go in.
Du går ut.	You go out.
Du går opp.	You go up.
Du går ned.	You go down.
Du går hjem.	You go home.
Du er inne.	You are in/inside.
Du er ute.	You are out/outside.
Du er oppe.	You are up/upstairs.
Du er nede.	You are down/downstairs.
Du er hjemme.	You are home.
Du kommer hit.	You come here.
Du går der.	You go there.
Du er her.	You are here.
Du er der.	You are there.
en brun stol	a brown chair
ei brun seng	a brown bed
et brunt bord	a brown table
brune stoler	brown chairs
Stolen er brun.	The chair is brown.
Senga er brun.	The bed is brown.
Bordet er brunt.	The table is brown.
Stolene er brune.	The chairs are brown.
en ny bil	a new car
ei ny veske	a new handbag
et nytt skjerf	a new scarf
nye biler	new cars
en billig bil	a cheap car
ei billig veske	a cheap handbag
et billig skjerf	a cheap scarf
billige biler	cheap cars
en tysk bil	a German car
ei tysk veske	a German handbag
et tysk skjerf	a German scarf
tyske biler	German cars
en praktisk bil	a practical car
ei praktisk veske	a practical handbag
et praktisk skjerf	a practical scarf
praktiske biler	practical cars
en moderne bil	a modern car
ei moderne veske	a modern handbag
et moderne skjerf	a modern scarf
moderne biler	modern cars
en grønn bil	a green car
ei grønn veske	a green handbag
et grønt skjerf	a green scarf
grønne biler	green cars
snakket	å snakke (speak)
kjøpte	å kjøpe (buy)
prøvde	tried (try)
bodde	å bo (live)
ble	å bli (become)
fortalte	å fortelle (tell)
gikk	å gå (walk)
hjalp	å hjelpe (help)
møtte	å møte (meet)
sa	å si (say)
satt	å sitte (sit)
spurte	å spørre (ask)
sto(d)	å stå (stand)
tok	å ta (take)
traff	å treffe (meet)
ville	å ville (want/wish)
var	å være (be)
faren min	my father
mora mi	my mother
huset mitt	my house
bøkene mine	my books
faren din	your (sing.) father
mora di	your (sing.) mother
huset ditt	your (sing.) house
bøkene dine	your (sing.) books
faren hans	his father
mora hans	his mother
huset hans	his house
bøkene hans	his books
faren hennes	her father
mora hennes	her mother
huset hennes	her house
bøkene hennes	her books
faren vår	our father
mora vår	our mother
huset vårt	our house
bøkene våre	our books
faren deres	your (pl.) father
mora deres	your (pl.) mother
huset deres	your (pl.) house
bøkene deres	your (pl.) books
sønnen deres	their son
dattera deres	their daughter
barnet deres	their child
barna deres	their children
faren sin	his (own) father
mora si	his (own) mother
huset sitt	his (own) house
bøkene sine	his (own) books
faren sin	her (own) father
mora si	her (own) mother
huset sitt	her (own) house
bøkene sine	her (own) books
faren sin	their (own) father
mora si	their (own) mother
huset sitt	their (own) house
bøkene sine	their (own) books
et dokument	a document
ei fil	a file
et auditorium	an auditorium
ei kantine	a cafeteria, canteen
et laboratorium	a laboratory
et fakultet	a faculty
et studium	a study/studies
en grad	a degree
en dekanus	a dean/head of faculty
en instituttleder	a head of department
en konsulent	a consultant
en kontorsjef	a head of administration
en rektor	a head master
en sekretær	a secretary
en disputas	a presentation of a thesis
et fag	a subject
et foredrag	a lecture/speech
et innlegg	an oral or written contribution
en artikkel	an article
en konferanse	a conference
et møte	a meeting (formal)
en workshop	a workshop
Jeg er forkjølet.	I've got a cold.
Jeg har influensa.	I've got the flu.
Jeg har feber.	I've got a temperature.
Jeg er kvalm.	I am nauseous.
Jeg har vondt i ...	My ... hurts.
Jeg har vondt i halsen.	I've got a sore throat.
Jeg har vondt i magen.	I've got a stomachache.
Jeg har vondt i hodet.	I've got a headache.
Jeg har hodepine.	I've got a headache (...pine).
Jeg har tannpine.	I've got a toothache.
et album	an album
et barn	a child
en barnehage	a kindergarten
besteforeldre	grandparents
ei bestemor	a grandmother
både - og	both - and
ei datter	a daughter
deres	your (plural), yours, their, theirs
din	your, yours (singular)
et enebarn	an only child
et essay	an essay
en farfar	a (paternal) grandfather
ei farmor	a (paternal) grandmother
en forelder	a parent
foreldre	parents
fort	fast
ga	gave, offered
å gi	to give
å gifte seg	to get married, to marry
en grammatikk	a grammar
ei gruppe	a group
hans	his
hennes	hers
en ingeniør	an engineer
et IT-firma	an IT-firm
Kina	China
kjempesøt	very cute, very sweet
ei kone	a wife
en kontakt	a contact
ei lekse	a lesson, homework
lenge	long
en lillebror	a little/baby brother
mi	my, mine (f.)
min	my, mine (m.)
mine	my, mine (pl.)
en morfar	a (maternal) grandfather
ei mormor	a (maternal) grandmother
muntlig	verbal, oral
en nevø	a nephew
ei oldemor	a great grandmother
en onkel	an uncle
onkler	uncles
et ord	a word
en pensjonist	a pensioner
siden	ago
en slutt	an ending
som	who, which, that, what
en stefar	a stepfather
en sønn	a son
et søskenbarn	a cousin
så	so, then
ei tante	an aunt
et tema	a subject, topic, theme
til slutt	finally, in the end, eventually
en time	a lesson, class, session, also: hour
ei trening	a training session, practice session, exercise
en appelsin	an orange
bedre	better
bekymret	worried, anxious
en beskjed	a message
å blåse	to blow, be windy
borte	away, off, over
et bål	a fire
drikke	a drink (uncount. noun)
dårlig	bad, unwell, ill
elektrisitet	electricity (uncount. noun)
enkel	simple, easy
enn	than
finere	finer, nicer
å fryse	to be cold, freeze
å fyre	to kindle a fire, keep a fire going
gir	give(s), offer(s) (present)
å grille	to grill
en gryterett	a casserole
ei helg	a weekend
et hotell	a hotel
huff	exclamation: Oh! Ugh!
hyggeligere	nicer, kinder(comp. adj.)
ei hytte	a cabin
en hyttetur	a trip to a cottage
en høst	an autumn
i alle fall	at any rate
inni	inside, in
kakao	cocoa (uncount. noun)
kaldere	colder
kaldt	cold (n.)
en kjeks	a cracker, cookie
ei klasseliste	a class list
en kveld	an evening, night
makaroni	macaroni (uncount. noun)
mens	while
en minusgrad	one degree below zero, minus-degree
mørk	dark
nok	enough
oktober	October
en ovn	an oven
ei pølse	a sausage
regn	rain (uncount. noun)
å regne	to rain
å ringe	to ring, call
ris	rice (uncount. noun)
sagt (å si)	has said
en sekk	a sack
sjelden	seldom
å smake	to taste
å smile	to smile
å snø	to snow
snø	snow (uncount. noun)
en stund	a moment, while
syk	ill
å tenne	to light, kindle
typisk	typical
vant til	used to
å varme	to warm
en varmegrad	one degree above zero
varmere	warmer
en vinter	a winter
virkelig	really, indeed
vær	weather (uncount. noun)
akkurat	exactly, precisely
alene	alone
alvorlig	serious
en bedring	a recovery
elendig	miserable
ensom	lonely
en fastlege	a family doctor
en feber	a fever
febernedsettende	febrifugal, antipyretic
en fest	a party, fiest
å flytte	to move
for mye	too much
frisk	well, healthy, sound
å føle	to feel
et gulv	a floor
en hals	a throat, neck
en halstablett	a lozenge, throat pastille
hit	here
en influensa	an influenza, flu
å kaste opp	to throw up, vomit
en klem	a hug
kvalm	queasy
en lege	a doctor, GP
en legevakt	a casualty clinic
en legevaktsentral	telephone central for emergency clinic
å legge seg	to go to bed, lie down
å løpe	to run
en medisin	a medicine
nok	probably, I gather
en pakke	a package
en resept	a prescription
sin	his, hers, its, their own (m./f.)
sine	his, hers, its, their own (pl.)
sitt	his, hers, its, their own (n.)
smertestillende	painkilling
smittsom	infectious
en SMS	an SMS
å snakkes	to talk (to each other)
å søke om	to apply for
en tablett	a tablet
en tekstmelding	a text message
et telefonnummer	a phone number
et termometer	a thermometer
trist	sad
vond	painful, sore
vondt i halsen	a sore throat
å våkne	to wake up
alt (all)	all, everything (n.)
et bord	a table
en bygning	a building (verb?)
dessverre	unfortunately
ennå	yet, still
en etasje	a storey, floor
et etternavn	a surname
å forstå	to understand
å fylle ut	to fill in
en fødselsdato	a date of birth
første	first (adj.)
greit	all right
å hente	to fetch, pick up
en hybel	a bed-sitter, lodgings
ei inventarliste	a list of furniture, inventory
en kontrakt	a contract
ei liste	a list
lykke til!	good luck!
et mobilnummer	a cell phone number
en mobiltelefon	a cellular phone
et møbel	a piece of furniture
nr.	no.
en nøkkel	a key
et pass	a passport
en resepsjonist	a receptionist
et rom	a room
ei seng	a bed
et skjema	a form
å skrive	to write
å skrive under	to sign
å stave	to spell
en stol	a chair
et tall	a figure, number
ei trapp	a staircase, stairs
ut	out (movement)
ute	out, outside (stat.)
et utstyr	an equipment
en bursdag	a birthday
en del	a part
egentlig	really / strictly speaking
ekstra	extra, additional
ferdig	finished, ready, also slang; exhausted
forhånd	beforehand
et hovedpunkt	a main point
jo	yes (after negation)
ei kantine	a canteen
kjemisk	chemical
en ph.d.-student	a Ph.D. student, doctoral research fellow
en presentasjon	a presentation
et problem	a problem
et prosjekt	a project
på forhånd	in advance
samme	same
sann	true (masc/fem)
sant	true (n.)
sanne	true (flertall/bestempt entall)
et seminar	a seminar
stresset	stressed
uhøflig	impolite, rude
å utsette	to postpone
en veileder	a supervisor, guide
vennlig	friendly, kind
ei bløtkake	a layer cake
én	one
en korrektur	a proof, correction
et vedlegg	an attachment
et brukernavn	a username
bærbar	portable
en bærbar PC	a laptop
en colaboks	a can of Coke
ditt	your, yours (n.)
dyp	deep
en gang til	once more, one more time
å fikse	to fix, mend, organise
en flybillett	an airline ticket
å gjelde	to be valid, to concern
gratis	free (of charge), gratis
hele	whole (definite form)
et hotellrom	a hotel room
å huske på	to reflect on
høy	loud, high, tall
høyt	loud, high, tall (n.)
i går kveld	yesterday evening, last night
et innlegg	a post or submission
Internett	Internet
internettilgang	Internet access
ja da	"Sure", "Not to worry"
lenge siden	long ago
en mastergradsstudent	a master student
en minibar	a mini-bar
ei natt	a night
nei da	Oh no
nervøs	nervous
nesten	almost, nearly
en nyhet	a piece of news
å oppleve	to experience, enjoy
å ordne	to fix, organize
et passord	a password
en PC	a PC
å presentere	to present, introduce
pust	a breath (uncount. noun)
en reisebekreftelse	confirmation of travel reservation
en respons	response
sa	said
å sjekke inn	to check in
skulle	would/should
å skynde seg	to hurry (up)
tydelig	clear, explicit
å anbefale	to recommend
berømt	famous
å besøke	to visit
å dele ut	to distribute, award, deal (cards)
desember	December
en dronning	a queen
eldste	oldest, eldest (definite form)
en ende	an end
ene	one (definite form)
fantastisk	fantastic
en festning	a fortress
en fredag	a friday
en fredspris	a peace prize
fri	free
å gå på tur	to go for a hike
ei hovedgate	a main street
en hovedstad	a capital
en høstferie	an autumn vacation
kjent	well-known, famous
å male	to paint
en maler	a painter
man	one, you (impersonal form)
museer	museums
et museum	a museum
en nasjonalforsamling	a national assembly
en park	a park
et parlament	a parliament
en rest	a remainder, remnant, rest
riktig	correct, right
et rådhus	a city hall
shopping	shopping (uncount. noun)
sikkert	here: probably. Also: certainly
et skrik	a scream
et slott	a castle, palace
en søndag	a Sunday
et teater	a theatre
en utsikt	a view
en utstilling	an exhibition
et vikingskip	a Viking ship
Østlandet	Eastern Norway
alt mulig	everything
annet	other (n.)
å bake	to bake
burde	should/ought to (past tense)
en dessert	a dessert
å feire	to celebrate
et flagg	a flag
flest	most (countable)
en gave	a gift, present
glitter	tinsel (uncount. noun)
en grøt	a porridge
en gudstjeneste	a church service
hvit	white
i gamle dager	in the old days
å insistere	to insist
ei jul	a Christmas
en julaften (en julekveld)	a Christmas Eve
et julebord	a Christmas dinner, Christmas party
en julegave	a Christmas gift
ei julekule	a Christmas ball
en julemiddag	a Christmas dinner
en julestemning	a Christmas spirit
en juletradisjon	a Christmas tradition
et juletre	a Christmas tree
å kjenne	to feel, know
å kjenne igjen	to recognize
en kollega	a colleague
lagd	made (past tense)
en laks	a salmon
å lure	to wonder
lutefisk	«lie fish» (lut = lie/sodium hydroxide)
mer	more (uncountable)
merkelig	strange, odd (m...)
midnatt	midnight
midt i	in the middle of
mulig	possible
pinnekjøtt	mutton ribs (uncount. noun)
plutselig	suddenly
å prate	to talk/chat (informal)
en prest	a vicar, clergyman
pyntet	decorated
en rett	a dish
ei ribbe	a rib (pork ribs)
riskrem	creamed rice pudding (uncount. noun)
en sang	a song
en saus	a sauce, gravy
seg selv	oneself
selv	self
sju	seven
en småkake	a cookie
en sort	a sort, kind
en stemning	an atmosphere, mood
ei svineribbe	a breast of pork, ribs
en telefonsamtale	a telephone conversation
å telle	to count
en torsk	a cod
et tre	a tree
vanlig	usual, customary
verken - eller	neither - nor
å åpne	to open
en banan	a banana
billig	inexpensive, cheap
ei bolle	a bun
ei brødhylle	a bread rack
denne	this (masc/fem, near)
dette	this (neuter, near)
disse	these (pl., near)
dyr	expensive
et eple	an apple
forresten	by the way
et frimerke	a stamp
en fruktdisk	a fruit counter
å handle	to shop
ei handlevogn	a shopping cart
heldigvis	fortunately
hjem	home
hvilket	which (neuter)
i stedet	instead
en kasse	a cash register
en kjøledisk	a refrigerating counter
en kølapp	a queue number
ei lommebok	a wallet
en minibank	a cash dispenser
et minutt	a minute
opp	up
penger	money
et postkontor	a post office
et postkort	a postcard
en pris	a price
ei pære	a pear
rett ved siden av	right next to
å sende	to send
et senter	a centre
å slappe av	to relax
smør	butter
å ta ut penger	to withdraw money
en tikroning	ten-kroner-coin
å trekke	to draw, pull
å trenge	to need
et bad	a bath
å barbere seg	to shave
et brød	a loaf of bread
ei brødskive	a slice of bread
da	then
en dusj	a shower
en frokost	a breakfast
å glede seg til	to look forward to
gleder meg til	am looking forward to
å ha lyst på	to want
inne	in, inside
en italiener	an Italian (person)
en jus	a juice
kjempesulten	very hungry
et kjøleskap	a refrigerator
å kle på seg	to dress
å lage	to make
en lyst	a wish, desire, inclination
lyst på (å ha lyst på noe)	wanting something
mat	food
melk	milk
en nordmann	a Norwegian
en ost	a cheese
å pusse	to brush
salami	a salami (uncount. noun)
seg	himself, herself, itself, oneself, themselves
å sette seg	to sit down
ei skinke	a ham
ei skive	a slice
spennende	exciting
å stå opp	to get up
ei tann	a tooth
tenner	teeth
å treffe	to meet (casual)
å tørke	to dry
å tørke seg	to dry oneself
vet (å vite)	know (present tense)
å vite	to know
ei adresse	an address
av	off, of, by, from
en bagasje	luggage (uncount. noun)
å betale	to pay
å dra	to leave
gjerne	rather, would like
kan (å kunne)	can, be able to
å kjøre	to drive
klokka er...	the time is...
ei klokke	a clock, watch
å kunne	(the infinitive of) can, be able to
en mandag	a Monday
meg	me (Obj., refl.)
må (å måtte)	have to, must
en resepsjon	a reception
å se	to see
en sentralstasjon	a central station
å sjekke	to check
skal (å skulle)	will, shall, is going to
å skulle	will, shall
utvikler	developer (software)
en studentby	a student village
en taxi	a taxi
en taxisjåfør	a taxi driver
en vei	a road
vil (å ville)	wants to, will
å ville	to want to, will
et øyeblikk	a moment
åtte	eight
en buss	a bus
en bussjåfør	a bus driver
en busstur	a bus trip
flott	great, good
en flybuss	an airport express coach
for	for, because
å gå	to go, to walk
hei	hi
en hjelp	a help
å hjelpe	to help
inn	in, inside, into
en koffert	a suitcase
et kort	a card
å lande	to land
et nummer	a number
en pose	a bag (not handbag)
å rope	to call, cry, shout
selvfølgelig	of course
spør (å spørre)	ask (present tense)
å spørre	to ask
å stå	to stand
en tirsdag	a Tuesday
to	two, 2
tre	three, 3
utenfor	outside
å vente	to wait
ei veske	a handbag
at	that
å bety	to mean
en billett	a ticket
å bruke	to use
ei bussrute	a bus route
å bytte	to change, exchange
endelig	finally
å finne	to find
å få	to get, receive
halv	half
hvilken	which, what (masc/fem)
hvilke	which (flertall)
kvart	quarter
å ligge	to stand, lie
mye	much, a lot, plenty
ni	nine
når	when
en onsdag	a Wednesday
en overgang	a transition
et sentrum	a (town) centre
et skilt	a sign, signpost
en time	an hour, appointment, lesson
dem	them (obj.)
å drikke	to drink
ett	one (n.)
en ettermiddag	an afternoon
etterpå	afterwards
forbi	past, by
fram	ahead, on
først	at first (adv.)
høyre	right (direction)
en kafé	a café
en kaffe	a coffee
å kjøpe	to buy
et kjøpesenter	a shopping centre
en kopp	a cup
noen	some (m/f, plural), somebody, any, anybody
å parkere	to park
en parkeringsplass	a parking lot
rett	straight, directly
et rundstykke	a roll (food)
å spise	to eat
å stenge	to close
sulten	hungry
å takke	to thank
ti	ten
en torsdag	a Thursday
venstre	left
øst	east
aldri	never
andre	second, other
ei bokhylle	a book shelf
brun	brown
å bære	to carry
å dele	to share
ei dør	a door
en far	a father
fæl	awful
et gardin	a curtain
gjennom	through
hjemme	at home
høy	tall
et kjøkken	a kitchen
å legge	to lay, put
ei mor	a mother
å sette	to put, place, set
en sjokolade	a chocolate
et skap	a cupboard
et skrivebord	a desk
stille	quiet
stor	big
te	tea
å tenke	to think
under	under, below
ved siden av	beside
et vindu	a window
en bror	a brother
brødre	brothers
fin	fine (m./f.)
en gitar	a guitar
en gjest	a guest
et instrument	an instrument
kjempeflink	very good, clever
en kjøkkenbenk	a kitchen work table
å koke	to boil
en middag	a dinner
moderne	modern
musikk	music
et piano	a piano
å si	to say
å spille	to play
super	super
et søsken	a brother or sister, sibling
ei søster	a sister
så fint (...)!	what a nice (...)! (n.)
vann	water
en vannkoker	a kettle
bare	just, only
bare bra!	just fine!
bra	fine, good, well
en by	a city
en båt	a boat
en dag	a day
deg	you (singular)
den	it, that (masc/fem, far away)
det	it, that, the (neuter, far away)
det går bra!	I'm fine!
god	good
ha det bra!	goodbye!
ha det!	bye!
hallo	hello
her	here
å hilse	to greet with regards
hvordan	how
hyggelig	nice, pleasant
hyggelig å hilse på deg!	nice to meet you!
kanskje	perhaps, maybe
ledig	vacant
en morgen	a morning
å møte	to meet
nei	no
neste	next
nå	now
OK	okay, all right
seinere	later
å ses	to see one another
snart	soon
Spania	Spain
så	so
takk	thanks
en turist	a tourist
unnskyld	excuse me (my fault)
vi	we (subj.)
vær så god!	you're welcome! please! here you are!
å	to (infinitive marker)
ei avis	a newspaper
en bensinstasjon	a petrol station
en bil	a car
å bli	to become, will be, turn out
en brus	a (bottle of) soda pop
de	they, those (plural, faraway)
der	there
der borte	over there
en ekspeditør	a shop assistent
en	a, an, one
et	a, an (neuter)
god tur!	have a nice trip!
hvor langt	how far
et kart	a map
en kilometer	a kilometre
å koste	to cost
ei krone	a crown
langt	far (adv.; far [to go])
over	of, over
sammen	together
å stoppe	to stop
å ta	to take
tilbake	back
en tur	a trip
tusen	thousand
tysk	German
Tyskland	Germany
velkommen	welcome
en arkitektur	an architecture
engelsk	English
flink	good, clever
et fly	a plane
å gjøre	to do
ikke	not
Italia	Italy
italiensk	Italian
å jobbe	to work ("J")
litt	a little
norsk	Norwegian
også	too, also
en professor	a professor
på	on, at
Roma	Rome
spansk	Spanish
en student	a student
å studere	to study
å bo	to live(reside)
ei dame	a lady
du	you (sing., subj.)
ei	a/an, one (f.)
er (å være)	am, are, is
en familie	a family
fra	from
gammel	old
gift	married
å ha	to have
han	he, him
å hete	to be called
hun	she (subj.)
hva	what
hvor	where
i	in, at, on
ja	yes
ei jente	a girl
å komme	to come
med	with
men	but
Norge	Norway
og	and
å reise	to travel
seks	six
å snakke	to speak
til	to (prep.)
et tog	a train
å være	to be, exist
et år	a year
ei stue	a living room
et soverom	a bedroom
et toalett	a toilet
et bad	a bathroom
en kjeller	a basement
et loft	a loft
null	0
én	1 (m.)
ei	1 (f.)
ett	1 (n.)
to	2
tre	3
fire	4
fem	5
seks	6
sju	7
åtte	8
ni	9
ti	10
elleve	11
tolv	12
tretten	13
fjorten	14
femten	15
seksten	16
sytten	17
atten	18
nitten	19
tjue	20
tjueén	21
tjueto	22
tjuetre	23
tjuefire	24
tjuefem	25
tjueseks	26
tjuesju	27
tjueåtte	28
tjueni	29
tretti	30
et andebryst	a duck breast
en pannestekt andelever	a pan-fried duck liver
medium rå	medium rare
skjøkreps	crayfish
reker	shrimp
en krabbe	a crab
en arbeidsbenk	a workbench